{
  "width": 20,
  "height": 15,
  "map": [
    [0, 0, 36, 132, 68, 0, 0, 0, 0, 4, 36, 4, 4, 0, 0, 0, 0, 0, 0, 8],
    [8, 0, 4, 0, 0, 36, 0, 0, 4, 0, 8, 36, 0, 0, 0, 0, 0, 0, 4, 0],
    [36, 0, 8, 0, 0, 0, 0, 0, 0, 132, 0, 4, 0, 0, 0, 68, 68, 68, 0, 0],
    [0, 4, 8, 0, 4, 0, 0, 0, 36, 0, 0, 4, 0, 0, 36, 0, 132, 0, 0, 8],
    [0, 0, 0, 0, 4, 0, 0, 0, 0, 4, 0, 0, 0, 0, 4, 0, 0, 0, 0, 0],
    [0, 68, 0, 0, 0, 0, 0, 0, 0, 36, 0, 0, 0, 0, 0, 0, 0, 0, 4, 0],
    [0, 0, 0, 68, 0, 0, 4, 0, 0, 0, 0, 0, 0, 36, 0, 0, 0, 0, 0, 0],
    [0, 0, 0, 0, 0, 0, 0, 132, 0, 0, 0, 0, 0, 68, 0, 0, 0, 0, 0, 0],
    [0, 36, 0, 132, 0, 0, 0, 0, 0, 8, 0, 132, 0, 4, 0, 0, 0, 0, 0, 0],
    [0, 0, 0, 0, 0, 4, 132, 0, 132, 0, 0, 0, 0, 0, 0, 0, 0, 0, 0, 0],
    [0, 0, 0, 36, 36, 0, 132, 0, 0, 0, 0, 0, 8, 4, 8, 8, 0, 68, 0, 0],
    [0, 0, 0, 0, 0, 0, 0, 68, 8, 0, 36, 0, 0, 8, 0, 0, 0, 0, 0, 132],
    [0, 0, 0, 0, 0, 0, 0, 0, 0, 0, 0, 68, 68, 8, 0, 0, 0, 68, 0, 68],
    [0, 0, 0, 4, 36, 0, 0, 36, 0, 0, 0, 0, 0, 0, 0, 0, 0, 8, 36, 68],
    [0, 0, 0, 0, 0, 8, 68, 0, 0, 4, 0, 0, 4, 0, 0, 0, 0, 68, 4, 0]
  ],
  "player1_initial_x": 0,
  "player1_initial_y": 0,
  "player2_initial_x": 14,
  "player2_initial_y": 19,
  "player_vision": 5,
  "player_initial_health": 3,
  "player_initial_bomb_range": 2,
  "player_initial_trap_count": 1,
  "bomb_delay": 8,
  "max_bomb_range": 5,
  "deadzone_starting_step": 150,
  "deadzone_expansion_delay": 5,
  "max_step": 400
}
