{
  "width": 15,
  "height": 23,
  "player1_initial_x": 0,
  "player1_initial_y": 0,
  "player2_initial_x": 22,
  "player2_initial_y": 14,
  "player_vision": 3,
  "player_initial_health": 3,
  "player_initial_bomb_range": 3,
  "player_initial_trap_count": 1,
  "bomb_delay": 4,
  "max_bomb_range": 6,
  "deadzone_starting_step": 130,
  "deadzone_expansion_delay": 5,
  "max_step": 500,
  "map": [
  [0, 0, 0, 68, 0, 0, 8, 0, 0, 0, 4, 0, 0, 0, 68],
    [0, 0, 132, 36, 0, 0, 0, 0, 0, 0, 0, 0, 8, 8, 0],
    [0, 0, 8, 8, 8, 0, 0, 0, 0, 0, 4, 0, 8, 0, 0],
    [0, 0, 8, 0, 36, 132, 0, 4, 0, 0, 0, 0, 8, 0, 0],
   [0, 0, 8, 0, 0, 68, 0, 0, 0, 0, 0, 0, 8, 0, 0],
    [0, 0, 8, 0, 8, 8, 8, 36, 8, 8, 0, 0, 8, 0, 0],
    [0, 0, 8, 0, 0, 8, 0, 0, 0, 68, 0, 0, 8, 0, 0],
    [0, 0, 8, 0, 0, 132, 0, 0, 0, 8, 0, 0, 8, 0, 0],
    [0, 0, 8, 0, 0, 8, 0, 0, 0, 8, 0, 0, 8, 0, 0],
  [0, 36, 8, 0, 0, 8, 0, 0, 0, 8, 0, 0, 8, 0, 132],
    [68, 0, 8, 0, 0, 36, 8, 0, 0, 132, 8, 0, 8, 36, 0],
    [0, 0, 8, 0, 0, 68, 0, 8, 0, 68, 0, 0, 8, 0, 0],
    [0, 36, 8, 0, 8, 132, 0, 0, 8, 36, 0, 0, 8, 0, 68],
    [132, 0, 8, 0, 0, 8, 0, 0, 0, 8, 0, 0, 8, 36, 0],
  [0, 0, 8, 0, 0, 8, 0, 0, 0, 8, 0, 0, 8, 0, 0],
    [0, 0, 8, 0, 0, 8, 0, 0, 0, 132, 0, 0, 8, 0, 0],
    [0, 0, 8, 0, 0, 68, 0, 0, 0, 8, 0, 0, 8, 0, 0],
    [0, 0, 8, 0, 0, 8, 8, 36, 8, 8, 8, 0, 8, 0, 0],
    [0, 0, 8, 0, 0, 0, 0, 0, 0, 68, 0, 0, 8, 0, 0],
  [0, 0, 8, 0, 0, 0, 0, 0, 0, 132, 36, 0, 8, 0, 0],
    [0, 0, 8, 0, 0, 0, 0, 0, 0, 0, 8, 8, 8, 0, 0],
    [0, 8, 8, 0, 0, 0, 0, 0, 0, 0, 0, 36, 132, 0, 0],
  [68, 0, 0, 0, 0, 0, 0, 0, 0, 0, 0, 68, 0, 0, 0]
  ]
}
